X 0 C 0 I 0
X C H 0 H 0
0 0 0 0 H 0
K X L 0 H 0
X X X X F S