X 0 0 0 I 0
X I X 0 X 0
F 0 0 I 0 0
X 0 X 0 X I
X 0 I 0 0 S