0 C 0 0 0 0 0
0 H C H 0 H 0
0 0 0 S I 0 I
X 0 0 H 0 I 0
F L 0 C 0 0 K