0 0 0 0 0
0 C 0 0 I
0 0 0 0 0
0 0 S 0 R
0 0 0 0 0
0 K 0 L 0
0 0 0 0 0